


NO ./map/hive.png
SO ./map/hive_north.png
WE ./map/hive_h.png
EA ./map/bricks.png
F 160,170,180
C 199,199,199

1111111111111111111111111111111111111111111111111111111111111111111111111111111111111111
1000000000001000000000000000000000000000000000000000000000000000000000000000000000000001
1000000000001000000000000000000000000000000000000000000000000000000000000000000000000001
1000000000001000000000000000000000000000000000000000000000000000000000000000000000000001
1000000000001000111101111101111111111111010111111111111101111111111100000000000000000001
1111111111111000000101000100000000000000010000000000000000111111111100000000000000000001
100000000000100000010100010snsnsnsnsnsns010nsnsnsnsnsns000111111111100000000000000000001
1nsnsnsn00001000000101000100000000000000010000000000000000111111111100000000000000000001
1000000000001000000101000100000000000000010000000000000000111111111100000000000000000001
100000000000100000010100010snsnsnsnsnsns010nsnsnnnnnnns0001111111111000N0000000000000001
1nsnsnsn00001000000101111100000000000000010000001111000000111111111100000000000000000001
1000000000001000000000000100000000000000010000001111000000111111111100000000000000000001
100000000000000000000000010snsnsnsnsnsns010nsnsssssssns000111111111100000000000000000001
1nsnsnsn00001000000000000100000000000000010000000000000000111111111100000000000000000001
1000000000001111111111111100000000000000010000000000000000111111111100000000000000000001
100000000000100000000000010snsnsnsnsnsns010nsnsnsnsnsns000111111111100000000000000000001
1nsnsnsn00001000000000000100000000000000010000000000000000111111111100000000000000000001
1000000000001000000000000100000000000000010000000000000000000000000100000000000000000001
100000000000100000000000010snsnsnsnsnsns010000000000000000000000000100000000000000000001
1nsnsnsn00001000000000000100000000000000010nsnsnsnsnsns000nsnsnsnsn100000000000000000001
1000000000001000000000000100000000000000010000000000000000000000000100000000000000000001
1nsnsnsn0000100000000000010snsnsnsnsnsns010nsnsnsnsnsns000nsnsnsnsn100000000000000000001
1000000000001000000000000100000000000000010000000000000000000000000100000000000000000001
1111111111111111111111111111111111111111111111111111111111111111111111111111111111111111
